0,0,0,0,0,0,0,0,0,0,0,0,0,0,0,0,0,0,0,0,0,0,0,0,0,0,0,0,0,0,0,5369,0,0,5369,5369,5369,5369,5369,0,0,0,0,0,0,0,0,0,0,0,0,0,5700,5700,0,0,5700,5699,5699,5699,5699,5699,5699,5699,5699,5699,5699,5699,5699,5699,5699,5699,5699,5699,5699,5699,5699,5699,5699,5700,
0,0,0,0,0,0,0,0,0,0,0,0,0,0,0,8663,8664,0,0,0,0,0,0,0,0,0,0,0,0,0,5359,5369,5369,5369,5369,5369,5369,5369,5369,5369,5369,0,0,0,0,0,0,0,0,0,0,0,5700,5700,0,0,5700,5699,5699,5699,5699,5699,5699,5699,5699,5699,5699,5699,5699,5699,5699,5699,5699,5699,5699,5699,5699,5699,5699,5700,
0,0,0,0,0,0,0,0,0,0,0,0,0,0,0,8679,8680,0,0,0,0,0,0,0,0,0,0,0,0,0,5369,5369,0,0,0,0,0,0,0,5369,5369,5358,5338,0,0,0,0,0,0,0,0,0,5700,5700,0,0,5699,5699,5699,5699,5699,5699,5699,5699,5699,5699,5699,5699,5699,5699,5699,5699,5699,5699,5699,5699,5699,5699,5699,5700,
0,0,0,0,0,0,0,0,0,0,5034,0,0,0,0,8695,8696,0,0,0,0,0,0,0,0,0,0,0,0,0,5369,5369,0,5353,5353,5353,5353,5353,0,0,5369,5369,5369,0,0,0,0,0,0,0,0,0,5700,5700,5700,5700,5700,5699,5699,5699,5699,5699,5699,5699,5699,5699,5699,5699,5699,5699,5699,5699,5699,5699,5699,5699,5699,5699,5699,5700,
0,0,0,0,0,0,0,5034,5034,5034,5034,5034,5034,5034,5034,5034,5034,5034,0,0,0,0,0,0,0,0,0,0,0,0,5369,5369,0,5369,5369,5369,5369,5353,5353,0,5369,5369,5369,0,0,0,0,0,0,0,0,0,0,0,0,5700,5699,5699,5699,5699,5699,5699,5699,5699,5699,5699,5699,5699,5699,5699,5699,5699,5699,5699,5699,5699,5699,5699,5699,5699,
0,0,0,0,0,5034,5034,5034,5034,5034,5034,5034,5034,5034,5034,5034,5034,5034,5034,5034,0,0,0,0,0,0,0,0,0,5369,5369,0,0,5369,5369,5370,5354,5369,5369,0,0,5369,5369,0,0,0,0,0,0,0,0,0,0,0,0,5700,5699,5699,5699,5699,5699,5699,5699,5699,5699,5699,5699,5699,5699,5699,5699,5699,5699,5699,5699,5699,5699,5699,5699,5699,
0,0,0,5354,0,5034,5034,5034,5034,5034,5034,5034,5034,5034,5034,5034,5034,5034,0,0,5034,5359,5370,0,0,0,0,0,0,5369,5369,0,5369,5369,5369,5370,5370,5354,5354,5354,0,5369,5369,5369,5369,5369,5369,5369,5369,5369,5369,5369,5369,5369,5369,5700,5699,5699,5699,5699,5699,5699,5699,5699,5699,5699,5699,5699,5699,5699,5699,5699,5699,5699,5699,5699,5699,5699,5699,5699,
5359,5354,5354,5354,0,5034,5034,5034,5034,5034,5034,5034,5034,5034,5034,5034,5034,5034,5034,5034,0,5370,0,0,0,0,0,0,0,5369,5369,0,0,5369,5353,5369,5370,5370,5370,5370,0,5369,5369,5369,5369,5369,5369,5369,5369,5369,5369,5369,5369,5369,5369,5700,5699,5699,5699,5699,5699,5699,5699,5699,5699,5699,5699,5699,5699,5699,5699,5699,5699,5699,5699,5699,5699,5699,5699,5699,
0,5354,5353,5354,0,0,0,0,0,0,5337,5337,5337,5337,0,0,0,0,0,0,0,5353,0,0,0,0,0,0,0,5369,5369,5369,0,5369,5369,5369,5353,5353,5353,5369,0,5369,5369,0,0,0,0,0,0,0,0,0,0,0,0,0,0,0,0,0,0,5700,5700,5700,5700,5700,5700,5700,5700,5700,5700,5700,5700,5700,5700,5700,5700,5700,5700,5700,
5354,5354,5353,5353,5353,5354,5369,5369,5369,5369,5369,5369,5369,5369,5369,5369,5353,5354,5354,5354,0,0,0,0,0,0,0,0,0,0,5369,5369,0,0,0,0,0,0,0,0,0,5369,5369,0,0,0,0,0,0,0,0,0,0,0,0,0,0,0,0,0,0,5699,5699,5699,5699,5699,5699,5699,5699,5699,5699,5699,5699,5699,5699,5699,5699,5699,5699,5699,
5354,5354,5353,5354,5354,5354,5354,5354,5354,5354,5354,5354,5354,5354,5354,5354,5354,5354,5370,5370,0,0,0,0,0,0,0,0,0,0,0,5369,5369,5369,5369,5369,5369,0,0,5369,5369,5358,0,0,0,0,0,0,0,0,0,0,0,0,0,0,0,0,0,0,0,5699,5699,5699,5699,5699,5699,5699,5699,5699,5699,5699,5699,5699,5699,5699,5699,5699,5699,5699,
0,5354,5353,5353,5353,5353,5353,0,0,5353,5354,5370,5370,5370,5370,5370,5370,5370,5369,5369,0,0,0,0,0,0,0,0,0,0,0,0,5369,5369,0,0,0,5369,5369,5369,0,0,0,0,0,0,0,0,0,0,0,0,0,0,0,0,0,0,0,0,0,5699,5699,5699,5699,5699,5699,5699,5699,5699,5699,5699,5699,5699,5699,5699,5699,5699,5699,5699,
0,0,5369,5369,5369,5369,5369,5369,5369,5353,5353,5353,5353,5354,5369,5369,5369,5353,5353,5354,0,0,0,0,0,0,0,0,0,0,0,0,5354,5354,0,0,0,0,5369,5369,5369,5369,0,0,0,0,0,0,0,0,0,0,0,0,0,0,0,0,0,0,0,5699,5699,5699,5699,5699,5699,5699,5699,5699,5699,5699,5699,5699,5699,5699,5699,5699,5699,5699,
0,0,0,5353,5354,5354,5354,5354,5354,5354,5354,5354,5354,5354,5354,5354,5354,5354,5354,5354,5370,5370,0,0,0,0,0,0,0,0,0,0,5354,5354,0,0,0,0,0,0,0,0,0,0,0,0,0,0,0,0,0,0,0,0,0,0,0,0,0,0,0,5699,5699,5699,5699,5699,5699,5699,5699,5699,5699,5699,5699,5699,5699,5699,5699,5699,0,0,
0,0,0,5353,0,0,5370,5370,5370,5370,5370,5370,5370,5370,5370,5370,5370,5370,5353,5354,5354,0,0,0,0,0,0,0,0,0,0,0,5354,5354,0,0,0,0,0,0,0,0,0,0,0,0,0,0,0,0,0,0,0,0,0,0,0,0,0,0,0,5699,5699,5699,5699,5699,5699,5699,5699,5699,5699,5699,5699,5699,5699,5699,5699,5699,0,0,
0,0,0,5353,0,0,5353,5353,5353,5353,5353,5353,5353,5353,5353,5353,5354,5354,5354,5354,5370,0,0,0,0,0,0,0,0,0,0,0,5354,5354,0,0,0,0,0,0,0,0,0,0,0,0,0,0,0,0,0,0,0,0,0,0,0,0,0,0,0,0,0,0,0,0,0,0,0,0,0,0,0,0,0,0,0,0,0,0,
0,0,0,5369,0,0,0,5354,5354,5369,5369,5369,5353,5354,5354,5354,5354,5353,5354,5370,5370,0,0,0,0,0,0,0,0,0,0,0,5354,5354,0,0,0,0,0,0,0,0,0,0,0,0,0,0,0,0,0,0,0,0,0,0,0,0,0,0,0,0,0,0,0,0,0,0,0,0,0,0,0,0,0,0,0,0,0,0,
0,0,0,0,0,0,0,5353,0,0,5353,5353,5353,5353,5353,5353,5353,5369,5370,0,0,0,0,0,0,0,0,0,0,0,0,0,5354,5354,0,0,0,0,0,0,0,0,0,0,0,0,0,0,0,0,0,0,0,0,0,0,0,0,0,0,0,0,0,0,0,0,0,0,0,0,0,0,0,0,0,0,0,0,0,0,
0,0,0,0,0,5369,5369,5369,0,0,5369,5369,5369,5369,5369,5369,5369,5369,5370,0,0,0,0,0,0,0,0,0,0,0,0,0,5354,5354,0,0,5337,5337,0,0,0,0,0,0,0,0,0,0,0,0,0,0,0,0,0,0,0,0,0,0,0,0,0,5337,0,0,0,0,0,0,0,0,0,0,0,0,0,0,0,0,
0,0,0,0,0,0,0,0,0,0,0,0,0,0,0,5354,5354,0,0,0,0,0,0,0,0,0,0,0,0,0,0,0,5359,5353,5353,5353,5353,0,0,0,0,0,0,0,0,0,0,0,0,0,0,0,0,0,0,0,0,0,0,0,0,0,0,5353,5353,5353,5358,5337,0,0,0,0,0,0,0,0,0,0,0,0,
0,0,0,0,0,0,0,0,0,0,0,0,0,0,0,5354,5354,0,0,0,0,0,0,0,0,0,0,0,0,0,0,5359,5353,5369,0,0,0,5354,5354,5358,0,0,0,0,0,0,0,0,0,0,0,0,0,0,0,0,0,0,0,0,5359,0,0,5353,5353,5353,5353,5353,0,0,0,0,0,0,0,0,0,0,0,0,
0,0,0,0,0,0,0,0,0,0,0,0,0,0,0,5354,5354,0,0,0,0,0,0,0,0,0,0,0,0,0,0,5353,5369,5369,0,0,0,0,5353,5354,0,0,0,0,0,0,0,0,0,0,0,0,0,0,0,0,0,0,0,0,5353,5353,5353,5353,5353,5353,5353,5353,0,0,0,0,0,0,0,0,0,0,0,0,
0,0,0,0,0,0,0,0,0,0,0,0,0,0,0,5354,5354,5354,5354,5354,5354,5354,5354,5354,5354,5354,5354,5354,5354,5354,5353,5369,5369,0,0,0,0,0,5369,5370,5358,0,0,0,0,0,0,0,0,0,0,0,0,0,0,0,0,0,0,0,5353,5353,5353,5353,5353,5353,0,0,0,0,0,0,0,0,0,0,0,0,0,0,
0,0,0,0,0,0,0,0,0,0,0,0,0,0,0,5354,5354,5354,5354,5354,5354,5354,5354,5354,5354,5354,5354,5354,5354,5354,5353,5353,5369,5353,0,0,0,0,5369,5370,5354,0,0,0,0,0,0,0,0,0,0,0,0,0,0,0,0,0,0,0,5353,5353,5353,5353,5353,5353,0,0,0,0,0,0,0,0,0,0,0,0,0,0,
0,0,0,0,0,0,0,0,0,0,0,0,0,0,0,5354,5354,0,0,0,0,0,0,0,0,0,0,0,0,0,5369,5353,5369,5369,5353,5354,5354,5353,5354,5354,5354,0,0,0,0,0,0,0,0,0,0,0,0,0,0,0,0,0,0,0,0,0,0,5353,5353,5353,5353,0,0,0,0,0,0,0,0,0,0,5337,5337,5337,
0,0,0,5336,0,0,0,0,0,0,0,0,5339,0,0,5354,5354,0,0,0,0,0,0,0,0,0,0,0,0,0,0,0,0,5369,5353,5353,5353,5369,0,0,5370,0,0,0,0,0,0,0,0,0,0,0,0,0,0,0,0,0,0,0,0,0,5353,5353,0,0,0,0,0,0,0,0,0,0,0,0,5359,5353,5353,5353,
0,0,0,0,5353,5353,0,0,0,0,0,0,0,0,0,5354,5354,0,0,0,0,0,0,0,0,0,0,0,0,0,0,0,0,5343,5369,5369,5369,5369,0,0,0,0,0,0,0,0,0,0,0,0,0,0,0,0,0,0,0,0,0,0,0,0,5354,5354,0,0,0,0,0,0,0,0,0,0,0,0,5353,5369,5369,5353,
0,0,5353,5353,5369,5369,0,0,0,0,0,0,0,0,0,5354,5354,0,0,0,0,0,0,0,0,0,0,0,0,0,0,0,0,5354,5354,0,0,0,0,0,0,0,0,0,0,0,0,0,0,0,0,0,0,0,0,0,0,0,0,0,0,0,5354,5354,0,0,0,0,0,0,0,0,0,0,0,0,5369,5369,0,0,
0,0,5369,5369,5369,0,0,0,0,0,0,5370,5370,5358,5338,5354,5354,0,0,0,0,0,0,0,0,0,0,0,0,0,0,0,0,5354,5354,0,0,0,0,0,0,0,0,0,0,0,0,0,0,0,0,0,0,0,0,0,0,0,0,0,0,0,5354,5354,0,0,0,0,0,0,0,0,0,0,0,0,5369,5370,5353,5354,
0,0,5369,5369,5353,0,0,0,0,0,0,5369,5370,5354,5354,5358,5338,0,0,0,0,0,0,0,0,0,0,0,0,0,0,0,0,5354,5354,0,0,0,0,0,0,0,0,0,0,0,0,0,0,0,0,0,0,0,0,0,0,0,0,0,0,0,5354,5354,0,0,0,0,0,0,0,0,0,0,0,0,5369,5370,5353,5354,
0,0,5353,5353,5369,5358,5338,0,0,0,0,0,5370,5370,5353,5354,5354,5354,5354,0,0,0,0,0,0,0,0,0,0,0,0,0,0,5354,5354,0,0,0,0,0,0,0,0,0,0,0,0,0,0,5337,5359,0,5353,5353,5353,5353,0,0,5358,0,0,0,5354,5354,0,0,0,0,0,0,0,0,0,0,0,0,5369,5370,5353,5354,
0,0,5369,5369,5369,5369,5369,0,0,0,0,0,0,0,5369,5370,0,0,5370,0,0,0,0,0,0,0,0,0,0,0,0,0,0,5354,5354,0,0,0,0,0,0,0,0,0,0,0,5359,5353,5353,5353,5354,0,5353,5353,5353,5353,5353,0,0,0,0,0,5354,5354,0,0,0,0,0,0,0,0,0,0,0,0,0,0,5353,5354,
0,0,0,0,5369,5370,5370,0,0,0,0,0,0,0,5369,5369,5353,5369,5370,0,0,0,0,0,0,0,0,0,0,0,0,0,0,5354,5354,0,0,0,0,0,0,0,0,5359,5353,5353,5353,5353,5353,5354,5354,0,0,5353,5353,5353,5353,5354,5354,0,0,0,5354,5354,0,0,0,0,0,0,0,0,0,0,5369,5369,5353,5353,5353,0,
0,0,5369,5369,5369,5370,5370,0,0,0,0,0,0,0,5354,5354,5369,5369,5370,0,0,0,0,0,0,0,0,0,0,0,0,0,0,5354,5354,0,0,0,0,0,0,0,0,0,0,5353,5353,5353,5353,5354,0,0,0,5353,5354,5354,5353,5354,5354,0,0,0,5354,5354,0,0,0,0,0,0,0,0,0,5359,5369,5370,5353,5353,5353,5354,
0,0,0,0,5369,5370,0,0,0,0,0,0,0,0,0,5370,5369,5370,5370,0,0,0,0,0,0,0,0,0,0,0,0,0,0,5354,5354,0,0,0,0,0,0,0,0,5353,5353,5353,5353,5354,5353,5353,5353,5354,0,0,0,0,5354,5354,5354,0,0,0,5354,5354,0,0,0,0,0,0,0,0,0,5353,5369,5370,5353,5353,5354,5354,
0,0,5369,5369,5369,5370,5358,0,0,0,0,0,0,0,0,0,5354,5354,5354,5358,0,0,0,0,0,0,0,0,0,0,0,0,0,5354,5354,0,0,0,0,0,0,0,0,0,0,5353,5353,0,0,5353,5353,5354,5353,5354,5354,0,0,0,0,0,0,0,5354,5354,0,0,0,0,0,0,0,0,0,5353,5354,5354,5353,5353,5354,5370,
0,0,5369,5369,5369,5370,5370,5358,0,0,0,0,0,0,0,0,5354,5354,5354,5354,0,0,0,0,0,0,0,0,0,0,0,0,0,5354,5354,0,0,0,0,0,0,0,0,5359,5353,5353,5353,0,0,5354,5354,5354,5354,5354,5354,5353,5353,5354,0,0,0,0,5354,5354,0,0,0,0,0,0,0,5369,0,0,5354,5353,5353,5353,5353,0,
0,0,5369,5369,5369,5370,5370,0,0,0,0,0,0,0,0,0,5354,5354,5354,5354,0,0,0,0,0,0,0,0,0,0,0,0,0,5354,5354,0,0,0,0,0,0,0,0,5353,5354,5354,5353,5353,5353,5353,5353,5353,5353,5354,5354,5353,5353,5353,5354,5354,5354,5354,5354,5354,5354,5354,5354,5354,5354,5354,5354,5369,5353,5354,5353,5369,5353,5353,5353,5354,
0,0,0,0,5369,5369,5369,5358,0,0,0,0,0,0,0,0,5354,5354,5370,5370,0,0,0,0,0,0,0,0,0,0,0,0,0,5129,5129,5166,5354,5354,5354,5354,5354,5354,5354,5353,5354,5354,5353,5353,5353,5353,5353,5353,5354,5354,5354,5353,5353,5353,5354,5353,5354,5354,5354,5354,5354,5354,5354,5354,5354,0,0,5369,5353,5353,5369,5369,5353,5353,5353,5354,
0,0,0,0,0,5369,5369,5369,0,0,0,0,0,0,0,5359,5370,5370,5370,5370,0,0,0,0,0,0,0,0,0,0,0,0,0,5129,5129,5129,5354,5354,5354,5354,5354,5354,5354,5353,5353,5354,5353,5353,5353,5354,5354,5353,5353,5353,0,0,5353,5353,5353,0,0,0,0,0,0,0,0,0,5359,5353,5353,5369,5353,5369,5369,5370,0,0,0,0,
0,0,0,0,0,0,0,5369,5358,5339,0,0,0,0,5359,5370,5370,5370,5370,5370,5354,5354,5354,5354,5354,5354,5354,5354,5113,5114,5113,5113,5167,5129,5129,5130,5166,5114,0,0,0,0,0,5353,5353,0,0,5353,5353,5353,5353,5353,5353,5353,0,0,0,0,0,0,0,0,0,0,0,0,0,0,5353,5369,5369,5353,5353,5369,5370,0,0,5353,5353,5354,
0,0,0,0,0,0,0,5369,5370,5358,5338,5338,5338,5359,5370,5370,0,0,5370,5370,5354,5354,5354,5354,5354,5354,5354,5354,5129,5129,5129,5129,5129,5129,5129,5129,5129,5130,0,0,0,0,0,0,5353,5353,5353,5353,5353,0,0,0,0,0,0,0,0,0,0,0,0,0,0,0,0,0,0,0,5369,5369,5353,5353,5369,5370,0,0,5369,5353,5353,5354,
0,0,0,0,0,0,5369,5369,5369,5370,0,0,5370,5370,5370,5370,0,0,0,0,0,0,0,0,0,0,0,5167,5145,0,0,0,0,0,0,0,0,5130,0,0,0,0,0,0,0,0,0,0,5353,5353,5353,0,0,0,0,0,0,0,0,0,0,0,0,0,0,5359,5353,5353,5354,5353,5354,5354,5354,0,0,5370,5369,5353,5353,5354,
0,0,0,0,0,0,0,0,5369,5369,0,0,5370,5370,5370,0,0,0,0,0,0,0,0,0,0,0,0,5129,0,0,5130,5130,5130,5130,5130,5130,0,0,5166,0,0,0,0,0,0,0,0,0,0,0,0,0,0,0,0,0,0,0,0,0,0,0,0,0,0,5353,5354,5354,5354,5354,5354,5370,5370,5370,5370,5354,5354,5354,5353,5354,
0,0,0,0,0,0,0,0,0,0,0,0,0,0,0,0,0,0,0,0,0,0,0,0,0,0,0,5145,0,5146,5146,5146,5146,5146,5146,5146,5146,0,5130,0,0,0,0,0,0,0,0,0,0,0,0,0,0,0,0,0,0,0,0,0,0,0,0,0,0,5353,5354,5370,5370,0,0,5369,5369,5369,5369,5370,5370,5370,5354,5354
