5353,5353,5353,5353,5353,5353,5353,5353,5353,0,0,5353,5353,5353,5353,5353,5353,5353,5353,5353,5353,5353,5353,0,0,5353,5353,5353,0,0,5353,5353,5353,0,0,0,0,5353,5353,5353,5353,5353,5353,5353,5353,0,0,5353,0,0,5353,5353,5353,0,0,5353,5353,5353,5353,5353,5353,5353,5353,5353,5353,5353,0,0,5353,5353,5353,5353,0,0,5353,0,0,5353,0,0,
5353,5353,5353,5353,0,0,5353,5353,5353,5353,5353,5353,5353,5353,5353,5353,5353,5353,5353,5353,5353,5353,5353,5353,5353,5353,5353,5353,5353,5353,5353,5353,5353,0,0,0,0,0,0,5353,5353,5353,5353,5353,5353,0,0,5353,0,0,5353,5353,5353,0,0,5353,5353,5353,5353,5353,5353,5353,5353,5353,5353,5353,0,0,5353,5353,5353,5353,0,0,5353,0,0,5353,0,0,
5353,5353,5353,5353,0,0,5353,5353,5353,5353,5353,5353,5353,5353,5353,5353,5353,5353,5353,5353,5353,5353,5353,5353,5353,5353,5353,5353,5353,5353,5353,5353,5353,5353,0,0,0,0,0,0,0,0,0,0,0,0,5353,5353,0,0,5353,5353,5353,5353,5353,5353,5353,5353,5353,5353,5353,5353,5353,5353,5353,5353,5353,5353,5353,5353,5353,5353,5353,5353,5353,5353,5353,5353,5353,5353,
5353,5353,5353,5353,5353,5353,5353,5353,5353,5353,5353,5353,5353,5353,5353,0,0,0,5353,5353,0,0,0,0,0,5353,5353,5353,5353,5353,5353,5353,5353,5353,5353,5353,5353,5353,5353,5353,5353,5353,5353,5353,5353,5353,5353,5353,5353,5353,5353,5353,5353,5353,5353,5353,5353,5353,5353,5353,5353,5353,0,0,5353,5353,5353,5353,5353,5353,5353,5353,5353,5353,5353,5353,5353,5353,5353,5353,
0,0,5353,5353,5353,5353,5353,5353,5353,5353,0,0,0,0,0,0,5353,0,0,0,0,5353,5353,5353,0,5353,5353,5353,5353,5353,5353,5353,5353,5353,5353,5353,5353,5353,5353,5353,5353,5353,5353,5353,5353,5353,5353,5353,5353,5353,5353,5353,5353,5353,5353,5353,5353,0,0,5353,5353,5353,0,0,5353,5353,5353,5353,0,0,0,0,0,5353,5353,5353,5353,5353,5353,5353,
0,0,5353,5353,5353,5353,5353,5353,5353,5353,0,5353,0,0,5353,5353,5353,5353,5353,5353,5353,0,0,5353,0,5353,5353,5353,5353,5353,5353,5353,5353,5353,0,0,0,0,0,0,0,0,0,0,0,0,0,5353,5353,5353,5353,5353,5353,5353,5353,5353,5353,0,0,5353,5353,5353,5353,5353,5353,5353,0,0,0,0,0,5353,0,0,0,5353,5353,5353,0,0,
5353,5353,5353,5353,5353,5353,5353,0,0,0,0,5353,5353,5353,5353,5353,5353,5353,5353,5353,5353,0,0,5353,0,0,5353,5353,0,0,0,0,0,0,0,0,0,5353,5353,5353,5353,5353,5353,5353,5353,0,0,5353,5353,5353,5353,5353,5353,0,0,5353,5353,5353,5353,5353,5353,0,0,0,0,0,0,5353,5353,0,0,5353,0,0,0,5353,5353,5353,0,0,
5353,5353,5353,5353,5353,5353,0,0,5353,5353,5353,5353,5353,5353,5353,5353,5353,5353,5353,5353,5353,5353,5353,5353,5353,0,0,0,0,5353,5353,5353,5353,0,0,5353,0,0,0,0,5353,5353,5353,5353,5353,0,0,0,0,5353,5353,5353,5353,0,0,0,0,0,0,0,0,0,5353,5353,5353,5353,5353,5353,5353,0,0,5353,0,0,0,0,0,0,0,0,
5353,5353,5353,5353,5353,5353,0,5353,5353,5353,5353,5353,5353,0,0,5353,5353,5353,5353,5353,5353,5353,5353,5353,5353,0,0,5353,5353,5353,5353,5353,5353,0,0,5353,5353,5353,5353,0,0,0,0,0,0,0,0,0,0,0,0,0,0,0,0,0,5353,5353,0,0,5353,5353,5353,5353,5353,5353,5353,5353,5353,5353,5353,5353,5353,5353,5353,5353,5353,5353,5353,5353,
5353,5353,5353,5353,5353,5353,0,5353,5353,5353,5353,5353,5353,0,0,5353,5353,5353,5353,5353,5353,5353,5353,5353,5353,5353,5353,5353,5353,5353,5353,5353,5353,5353,5353,5353,5353,5353,5353,5353,5353,5353,5353,5353,5353,5353,5353,5353,5353,5353,5353,5353,5353,5353,5353,5353,5353,5353,0,0,5353,5353,5353,5353,5353,5353,5353,5353,5353,5353,5353,5353,5353,5353,5353,5353,5353,5353,5353,5353,
0,0,5353,5353,5353,0,0,5353,5353,5353,5353,5353,5353,5353,5353,5353,5353,5353,5353,5353,5353,5353,5353,5353,5353,5353,5353,5353,5353,5353,5353,5353,5353,5353,5353,5353,5353,5353,5353,5353,5353,5353,5353,5353,5353,5353,5353,5353,5353,5353,5353,5353,5353,5353,5353,5353,5353,5353,5353,5353,5353,5353,5353,5353,5353,5353,5353,5353,5353,5353,5353,5353,5353,5353,5353,5353,5353,5353,5353,5353,
5353,5353,5353,5353,5353,5353,5353,5353,5353,5353,5353,5353,5353,5353,5353,5353,5353,5353,5353,5353,5353,5353,5353,5353,5353,5353,5353,5353,5353,5353,5353,5353,5353,5353,5353,5353,5353,5353,5353,5353,5353,5353,5353,5353,5353,5353,5353,5353,5353,5353,5353,5353,5353,5353,5353,5353,5353,5353,5353,5353,5353,5353,5353,5353,5353,5353,5353,5353,5353,5353,5353,5353,5353,5353,5353,5353,5353,5353,5353,5353,
5353,5353,5353,5353,5353,5353,5353,5353,5353,5353,5353,5353,5353,5353,5353,5353,5353,5353,5353,5353,5353,5353,5353,5353,5353,5353,5353,5353,5353,5353,5353,5353,5353,5353,5353,5353,5353,5353,5353,5353,5353,5353,5353,5353,5353,5353,5353,5353,5353,5353,5353,5353,5353,5353,5353,5353,5353,5353,5353,5353,5353,5353,5353,5353,5353,5353,5353,5353,5353,5353,5353,5353,5353,5353,5353,5353,5353,5353,5353,5353,
0,0,5353,5353,5353,5353,5353,5353,5353,5353,5353,5353,5353,5353,5353,5353,0,0,5353,5353,5353,5353,5353,5353,5353,5353,5353,5353,5353,5353,0,0,5353,5353,0,5353,5353,5353,5353,0,5353,5353,5353,5353,0,0,5353,5353,5353,5353,5353,5353,5353,5353,5353,5353,5353,5353,5353,5353,5353,5353,5353,5353,5353,5353,5353,5353,5353,5353,5353,5353,5354,5353,5353,5353,5353,5353,5353,5353,
0,0,5353,5353,5353,5353,5353,5353,5353,5353,5353,5353,5353,5353,5353,5353,0,0,5353,5353,5353,5353,5353,0,0,5353,5353,5353,5353,5353,0,0,5353,0,0,5353,5353,5353,5353,0,0,0,0,0,0,0,5353,5353,5353,5353,5353,5353,5353,5353,5353,5353,5353,0,0,5353,5353,5353,5353,5353,5353,5353,5369,5369,5353,5353,5353,5353,5353,5353,5353,5353,5354,5354,5353,5354,
0,0,0,0,0,0,0,5353,0,0,5353,5353,5353,5353,5353,5353,0,0,0,0,0,0,0,5353,5353,5353,0,0,0,0,0,0,0,0,0,5353,5353,5353,5353,0,0,0,0,0,0,5353,5353,5353,5353,5353,5353,5353,0,0,0,0,0,0,0,5369,5369,5353,5354,5354,5354,5354,5354,5370,5369,5369,5369,5369,5369,5369,5369,5353,5354,5370,5354,5354,
0,0,0,0,0,0,0,5353,5353,5353,5353,5353,5353,5353,5353,5353,0,0,0,0,0,0,0,0,0,0,0,0,0,0,0,0,0,0,0,5353,5353,5353,5353,0,0,0,0,0,0,5353,5353,5353,5353,5353,5353,5353,0,0,0,0,0,0,0,0,0,5369,5370,5370,5370,5370,5370,0,0,5354,5354,0,0,0,0,5369,5370,0,0,5354,
0,0,0,0,0,0,0,0,0,0,0,5353,5353,5353,5353,5353,0,0,0,0,0,0,0,0,0,0,0,0,0,0,0,0,0,0,0,5353,5353,5353,5353,0,0,0,0,0,0,5353,5353,0,0,0,0,5353,0,0,0,0,0,0,0,0,0,0,0,0,0,0,5369,5370,5370,5370,5370,0,0,0,0,0,0,5369,5370,5370,
0,0,0,0,0,0,0,0,0,0,0,0,0,0,0,0,0,0,0,0,0,0,0,0,0,0,0,0,0,0,0,0,0,0,0,5353,5353,5353,5353,0,0,0,0,0,0,0,0,0,0,0,0,0,0,0,0,0,0,0,0,0,0,0,0,0,0,0,0,0,0,0,0,0,0,0,0,0,0,0,0,0,
0,0,0,0,0,0,0,0,0,0,0,0,0,0,0,0,0,0,0,0,0,0,0,0,0,0,0,0,0,0,0,0,0,0,0,5353,5353,5353,5353,0,0,0,0,0,0,0,0,0,0,0,0,0,0,0,0,0,0,0,0,0,0,0,0,0,0,0,0,0,0,0,0,0,0,0,0,0,0,0,0,0,
0,0,0,0,0,0,0,0,0,0,0,0,0,0,0,0,0,0,0,0,0,0,0,0,0,0,0,0,0,0,0,0,0,0,0,5353,5353,5353,5353,0,0,0,0,0,0,0,0,0,0,0,0,0,0,0,0,0,0,0,0,0,0,0,0,0,0,0,0,0,0,0,0,0,0,0,0,0,0,0,0,0,
0,0,0,0,0,0,0,0,0,0,0,0,0,0,0,0,0,0,0,0,0,0,0,0,0,0,0,0,0,0,0,0,0,0,0,5353,5353,5353,5353,0,0,0,0,0,0,0,0,0,0,0,0,0,0,0,0,0,0,0,0,0,0,0,0,0,0,0,0,0,0,0,0,0,0,0,0,0,0,0,0,0,
0,0,0,0,0,0,0,0,0,0,0,0,0,0,0,0,0,0,0,0,0,0,0,0,0,0,0,0,0,0,0,0,0,0,0,5353,5353,5353,5353,0,0,0,0,0,0,0,0,0,0,0,0,0,0,0,0,0,0,0,0,0,0,0,0,0,0,0,0,0,0,0,0,0,0,0,0,0,0,0,0,0,
0,0,0,0,0,0,0,0,0,0,0,0,0,0,0,0,0,0,0,0,0,0,0,0,0,0,0,0,0,0,0,0,0,0,0,5353,5353,5353,5353,0,0,0,0,0,0,0,0,0,0,0,0,0,0,0,0,0,0,0,0,0,0,0,0,0,0,0,0,0,0,0,0,0,0,0,0,0,0,0,0,0,
0,0,0,0,0,0,0,0,0,0,0,0,0,0,0,0,0,0,0,0,0,0,0,0,0,0,0,0,0,0,0,0,0,0,0,5353,5353,5353,5353,0,0,0,0,0,0,0,0,0,0,0,0,0,0,0,0,0,0,0,0,0,0,0,0,0,0,0,0,0,0,0,0,0,0,0,0,0,0,0,0,0,
0,0,0,0,0,0,0,0,0,0,0,0,0,0,0,0,0,0,0,0,0,0,0,0,0,0,0,0,0,0,0,0,0,0,0,5353,5353,5353,5353,0,0,0,0,0,0,0,0,0,0,0,0,0,0,0,0,0,0,0,0,0,0,0,0,0,0,0,0,0,0,0,0,0,0,0,0,0,0,0,0,0,
0,0,0,0,0,0,0,0,0,0,0,0,0,0,0,0,0,0,0,0,0,0,0,0,0,0,0,0,0,0,0,0,5359,0,0,5353,5353,5353,5353,5358,5338,5338,5338,0,0,0,0,0,0,0,0,0,0,0,0,0,0,0,0,0,0,0,0,0,0,0,0,0,0,0,0,0,0,0,5337,5337,0,0,5337,5337,
0,0,0,0,0,0,0,0,0,0,0,0,0,0,0,0,0,0,0,0,0,0,0,0,0,0,0,0,5337,5359,0,0,5353,5353,5353,5353,5353,5353,5353,5353,0,0,5353,5353,5353,5358,0,0,0,0,0,0,0,0,0,0,0,0,0,0,0,0,0,0,5337,0,0,0,0,0,0,0,0,5359,5353,5354,0,0,5354,5354,
0,0,0,0,0,0,0,0,0,0,0,0,0,0,0,0,0,0,0,0,0,0,0,0,0,5337,5337,5359,5353,5353,5353,5353,5353,5353,5353,5353,5353,5353,5353,5353,0,0,5353,5353,5353,5353,5358,5337,5337,5337,0,0,0,0,0,0,0,0,0,0,0,5359,0,0,5353,0,0,5358,5338,5338,5359,5353,5354,5354,0,0,5370,5370,5370,5370,
0,0,5337,5337,5337,5337,5337,0,0,0,0,0,0,0,0,0,0,5338,0,0,5337,5337,5337,0,0,5353,5353,5353,5353,5353,5353,5353,5353,5353,5353,5353,5353,5353,5353,5353,5353,5353,5353,5353,5353,5353,5353,5353,5353,5353,5358,5337,0,0,5337,5337,5359,0,0,0,0,5353,5369,5369,5369,5353,5353,5353,0,0,5353,5369,5370,5370,0,0,5353,5353,5353,5353,
0,0,5353,5353,5353,5353,5353,0,0,0,0,0,0,0,0,5338,5359,5353,0,0,5353,5353,5353,0,0,5353,5353,5353,5353,5353,5353,5353,5353,5353,5353,5353,5353,5353,5353,5353,5353,5353,5353,5353,5353,5353,5353,5353,5353,5353,5353,5353,0,0,0,0,0,0,0,0,0,0,5369,5370,5353,5369,5369,5369,5369,5369,5369,5369,5369,5369,5369,5369,5369,5369,5369,5369,
5353,5353,5353,5353,5353,5353,5353,5353,5353,5358,5338,5338,5338,5338,5359,5353,5353,5353,5353,5353,5353,5353,5353,0,0,5353,5353,5353,5353,5353,5353,5353,5353,5353,5353,5353,5353,5353,5353,5353,5353,5353,5353,5353,5353,5353,5353,5353,5353,5353,5353,5353,5353,5353,0,0,5353,5353,5353,5353,0,0,0,5353,5353,5353,5353,5353,5353,5353,5353,5353,5353,5353,5353,5353,5353,5353,5353,5353,
5353,5353,5353,5353,5353,5353,5353,0,0,5353,5353,5353,5353,5353,5353,5353,5353,5353,5353,5353,5353,5353,5353,5353,5353,5353,5353,5353,5353,5353,5353,5353,5353,5353,5353,5353,5353,5353,5353,5353,5353,5353,5353,5353,5353,5353,5353,5353,5353,5353,5353,5353,5353,5353,0,0,5353,5353,5353,5353,0,0,0,5353,5353,5353,5353,5353,5353,5353,5353,5353,5353,5353,5353,5353,5353,5353,5353,5353,
5353,0,0,5353,5353,5353,5353,5353,5353,5353,5353,5353,5353,5353,5353,5353,5353,5353,5353,5353,5353,5353,5353,5353,5353,5353,5353,5353,5353,5353,5353,5353,5353,5353,5353,5353,5353,5353,5353,5353,5353,5353,5353,5353,5353,5353,5353,5353,5353,5353,5353,0,0,0,0,0,5353,5353,5353,5353,5353,5353,0,5353,0,0,5353,5353,5353,5353,5353,5353,5353,5353,5353,5353,5353,5353,5353,5353,
5353,5353,5353,5353,5353,5353,5353,5353,5353,5353,5353,5353,5353,5353,5353,5353,5353,5353,5353,5353,5353,5353,5353,5353,5353,5353,5353,5353,5353,5353,5353,5353,5353,5353,5353,5353,5353,5353,5353,5353,5353,5353,5353,5353,5353,5353,5353,5353,5353,5353,5353,0,5353,5353,0,0,0,0,0,5353,5353,0,0,5353,5353,5353,5353,5353,5353,5353,5353,5353,5353,5353,5353,5353,5353,5353,5353,5353,
5353,5353,5353,5353,5353,5353,5353,5353,5353,5353,5353,5353,5353,5353,5353,5353,5353,5353,5353,5353,5353,5353,5353,5353,5353,5353,5353,5353,5353,5353,5353,5353,5353,5353,5353,5353,5353,5353,5353,5353,5353,5353,5353,5353,5353,5353,5353,5353,5353,5353,5353,0,5353,5353,0,0,0,0,0,5353,0,0,5353,5353,5353,5353,5353,5353,5353,5353,5353,5353,5353,5353,5353,5353,5353,5353,5353,5353,
5353,5353,5353,5353,5353,5353,5353,5353,5353,5353,5353,5353,5353,5353,5353,5353,5353,5353,5353,5353,5353,5353,5353,5353,5353,5353,5353,5353,0,0,5353,5353,5353,5353,5353,5353,5353,5353,5353,5353,5353,5353,5353,0,0,5353,0,0,0,0,0,0,5353,5353,5353,5353,5353,5353,5353,5353,5353,0,0,0,5353,5353,5353,5353,5353,5353,5353,5353,5353,5353,5353,5353,5353,5353,5353,5353,
5353,0,0,5353,5353,5353,0,0,5353,5353,5353,5353,5353,5353,5353,5353,5353,5353,5353,5353,0,0,0,0,0,0,0,0,0,0,5353,5353,5353,5353,5353,5353,5353,5353,5353,5353,5353,5353,5353,0,0,5353,0,5353,5353,5353,5353,5353,5353,5353,5353,5353,5353,5353,5353,5353,5353,0,0,0,5353,5353,5353,5353,5353,5353,5353,5353,5353,5353,5353,5353,5353,5353,5353,5353,
5353,5353,5353,5353,5353,0,0,0,0,5353,0,0,5353,5353,5353,5353,5353,5353,0,0,0,0,0,0,0,0,0,0,0,0,0,5353,5353,5353,5353,5353,5353,5353,0,0,5353,0,0,0,0,0,0,5353,5353,5353,5353,5353,5353,5353,5353,5353,5353,5353,5353,5353,5353,0,0,0,5353,5353,5353,5353,5353,5353,5353,5353,5353,5353,5353,5353,5353,5353,5353,5353,
5353,5353,5353,5353,5353,5353,0,0,5353,5353,5353,5353,5353,5353,5353,5353,5353,5353,5353,5353,0,0,0,0,5353,5353,5353,5353,5353,5353,0,0,0,5353,5353,5353,5353,5353,0,0,5353,0,0,0,5353,5353,5353,5353,5353,5353,5353,5353,5353,5353,5353,5353,5353,5353,5353,5353,5353,5353,5353,0,0,5353,5353,5353,5353,5353,5353,5353,5353,5353,5353,5353,5353,5353,5353,5353,
5353,5353,5353,5353,5353,5353,5353,5353,5353,5353,5353,5353,5353,5353,5353,5353,5353,5353,5353,0,0,0,0,0,0,0,0,0,5353,5353,0,0,0,5353,5353,5353,5353,5353,5353,5353,5353,0,0,0,5353,5353,5353,5353,5353,5353,5353,5353,5353,5353,5353,5353,5353,5353,5353,5353,5353,5353,5353,5353,5353,5353,0,0,5353,5353,5353,5353,5353,5353,5353,5353,5353,5353,5353,5353,
0,0,5353,5353,5353,5353,5353,5353,5353,5353,5353,5353,5353,5353,5353,5353,5353,0,0,0,0,0,0,0,0,0,0,0,5353,5353,5353,5353,0,0,0,0,0,0,0,5353,5353,0,5353,5353,5353,5353,5353,5353,5353,5353,5353,5353,5353,5353,5353,5353,5353,5353,5353,5353,5353,5353,5353,5353,5353,5353,5353,5353,5353,5353,5353,5353,5353,5353,5353,5353,5353,5353,5353,5353,
5353,5353,5353,5353,5353,5353,5353,5353,5353,5353,5353,5353,0,0,0,0,0,0,0,0,0,5353,0,0,0,0,0,0,0,0,0,0,0,0,5353,5353,0,0,0,5353,5353,0,5353,5353,5353,5353,5353,5353,5353,5353,5353,5353,5353,5353,5353,5353,5353,5353,5353,5353,5353,5353,5353,5353,5353,5353,5353,5353,5353,5353,5353,5353,5353,5353,5353,5353,0,0,0,0,
5353,0,0,5353,5353,5353,5353,5353,5353,5353,5353,5353,0,0,5353,0,0,0,0,0,0,5353,0,0,0,0,0,0,0,0,0,0,0,0,0,0,0,0,0,5353,5353,0,5353,0,0,5353,5353,5353,5353,5353,5353,5353,5353,5353,5353,5353,5353,5353,5353,0,0,5353,5353,5353,5353,5353,5353,5353,5353,0,0,5353,0,0,5353,5353,0,0,0,0,
5353,0,0,5353,5353,5353,5353,5353,5353,0,0,5353,0,0,0,0,0,0,0,0,0,5353,0,0,0,0,0,0,0,0,0,0,0,0,0,0,0,5353,0,5353,5353,0,5353,0,0,5353,5353,5353,5353,5353,5353,5353,5353,5353,5353,5353,5353,5353,5353,5353,5353,5353,5353,5353,0,0,0,5353,5353,0,0,5353,5353,5353,5353,5353,0,0,0,0
